SO textures/Bricks.xpm

C 225,30,0

NO textures/Planks.xpm

EA textures/Glass.xpm

F 224,14,0

WE textures/bookshelf.xpm

     111111111
    1000S00001
  11100010001
 10000010001
 11111111111
