NO ../files/north_texture

SO ../files/south_texture

WE ../files/west_texture

EA ../files/east_texture

F 220,100,0

C 225,30,0



11111111111111111111111111111111111111111
101S1000000001111100000000000000000000001
10001000000000000011111010110110110110101
10000000000000000000000010100100100100101
11111111111111111111111111111011011011001
10000000000000000000000000000000000000001
10111111111111111111111111111111111111111
10000000000000000000000000000000000000001
10101010101010101010101010101010101010101
10000000000000000000000000000000000000001
11010101010101010101010101010101010101011
10000000000000000000000000000000000000001
10101010101010101010101010101010101010101
10000000000000000000000000000000000000001
11010101010101010101010101010101010101011
11010101010101010101010101010101010101011
11010101010101010101010101010101010101011
11111111111101111111111111111111111111111
11111111111101111111111111111111111111111
11111111111101111111111111111111111111111
11111111111000111111111111111111111111111
11111111110000011111111111111111111111111
11111111100000001111111111111111111111111
11111111110000011111111111111111111111111
11111111111000111111111111111111111111111
11111111111111111111111111111111111111111