NO textures/Bricks.xpm

SO textures/Glass.xpm

WE textures/Planks.xpm

EA textures/bookshelf.xpm

F 224,14,0

C 0,30,0

     111111111
    1000S00001
  11100010001
 10000010001
 11111111111
