NO ../files/north_texture

SO ../files/south_texture

WE ../files/west_texture

EA ../files/east_texture

F 220,100,0

C 225,30,0
                            
                       1111       111
1 1111 1111  11111    100001     10001
 1001 10001 1000011  10000001   1000001
111001110001000001111000000001 100000001
100000000000000000000000000000100000001
111110000000000000001111111000000000001
    10000000000000001     100000000001
1  11000000000000001       1111001111
1  10000000000000001          1001 
1 1000011111111000011          1001            
 1000001      10000001          1001 
10000001   1  100000001          1001 
100N0001   1111000000001          1001
10000001   100000000111          1001 
11111111   111111111            1001
                               1001 
                            111001                           
                           100001
                          1100111 
                         100011
                         11001 
                          1001
                          1001 
                          1001 
111                       1001 
101                       1001
101111111111111111111111111001
100000000000000000000000000001 
111111111111111111111111111111
                         