NO textures/Bricks.xpm

SO textures/Glass.xpm

WE textures/Planks.xpm

EA textures/bookshelf.xpm

F 220,100,0

C 225,30,0

     111111111
    10000000S1
  11100010001
 100000100N1
 11111111111