NO textures/Glass.xpm

SO textures/bookshelf.xpm

WE textures/Bricks.xpm

EA textures/Planks.xpm

F 220,100,0

C 225,30,0

    1111011111  11                  1111111
    1000S00101 101                  1000001
  11100010001   1                   1111111
 100000101001     
 11111111111     1111
111              1001
101              1001
111  1111111111  1111
    1000000001
  11100010001
 10000010001
 11100000001
11111111111